NO ./textures/north_wall.png
SO ./textures/south_wall.png
WE ./textures/west_wall.png
EA ./textures/east_wall.png

F 70,130,180
C 135,206,235

111111111111111111111111111111111
100000000001100000000000000000001
101100000111000000000000000000001
100100000000000000000000000000001
100100000111000000000000000000001
100000000111011111111111111111111
111101111111101110000000000100001
111101111111101110101000000100001
110000001101010111000000000100001
100000000000000011000000000100001
100000000000000011010100000100001
110000011101010111110111110N00001
111101111111010111110100000100001
111111111111111111111111111111111
