1111111111111
1P000011100E1
10000C1C10001
1011111011001
1C00100010001
10000C000C111
1111111111111