11111111111111111111111111111111111111111111111111
10000000000000000000000000000000000000000000000001
10000000000000000010111000100000000000000000000001
10000000000000000010110000010000000000000000000001
10000000000000000100101000000000000000000000000001
10000000000000000100100100001000000000000000000001
10000000000000000100100100001000000000000000000001
10000000000000000000100010001000000000000000000001
10000000000000001000100010001000000000000000000001
10000000000000001000100010001000000000000000000001
10000000000000001000100010000000000000000000000001
10000000000000001000111010000100000000000000000001
10000000000000001000110010000100000000000000000001
10000000000000001000110100000100000000000000000001
1000000000000000100011E100000100000000000000000001
10000000000000000100010000001000000000000000000001
10000000000000000010000000010000000000000000000001
10000000000000000000010000010000000000000000000001
10000000000000000010010000011000000000000000000001
10000000000000000011100100101100000000000000000001
10000000000000000000000011000010000000000000000001
10000000000000000100000000000001000000000000CCCC01
100000000000000010000000000000000000CC000000000001
10000000000000000000000000000000010C00000000000001
10000000000000010000000000000000001100CCC000000001
10000000000000100000000000000011110010000000CCCCC1
10000000000000100000000000011100001000000000000001
10000000000001000000000001100000011100000000000001
100000000000100000000000100000000001000CC000C00001
10000000000100000000001010000000000100000000000001
10000000001000000000110001000000011000000000000001
1000000011000000001100000001111110000000000000C001
100000000000000001000000000110000000000000CC000C01
10000000000000010000000001100000000000000000C00C01
10000000000000100000000110000000000000000000000001
10000000000010000000011000000000000000000000000001
10000000001100000001100000000000000000000000000001
10000000110000000110000000000000000000000000000001
10001110000000011000000000000000000000000000000001
10010000000001100000000000000000000000000000000001
11000000000110000000000000000000000000000000000001
10000000000000000000000000000000000000000000000001
10000000000010000000000000000000000000000000000001
10000000000000000000000000000000000000000000000001
10000000000000000000000000000000000000000000000001
10000000000010000000000000000000000000000000000001
1000000P000100000000000000000000000000000000000001
10000000011000000000000000000000000000000000000001
10001111000000000000000000000000000000000000000001
11111111111111111111111111111111111111111111111111