11111111111111111
11111111111111111
1110001111C01E111
110C100C111000011
11011110110010111
1101C110100110111
110001100C1100C11
111P11111000R1111
11111111111111111
11111111111111111