1111111111111
11111R111C1E1
11110C1C10001
11111010110R1
1C10101010001
1P000C000C101
1111111111111