1111111111111
111110111C1E1
11110C1C10001
1111101011001
1C10101010001
1P000C000C101
1111111111111