111111111111111
111111111111111
11E11C000000C11
110100111110R11
11P0011C0000011
111111111111111
111111111111111