1111111111111111111
1111111111111111111
110000C1100C0R01E11
11P1010000111101011
1111R10110000001C11
11C00001111111C0011
1111111111111111111
1111111111111111111