1111111111111111111
1111111111111111111
110000C1100C0001E11
11P1010000111101011
1111010110000001C11
11C00001111111C0011
1111111111111111111
1111111111111111111