1111111111111
1P001011100E1
10100C1C10011
1011101011001
1C10111010001
10000C000C101
1111111111111