11111111111111111111
1C0000C001100000C1E1
1010110100C010111101
101001110110101C1001
10110000010010000011
10C1C101110111010111
10111101000C10C11111
100000C101111011C001
10110111000C00000101
10010000010011110101
1P00C01C111000C001C1
11111111111111111111